1,1,1,1,1,1,1,1,1,1,1,1
1,1,1,1,1,1,1,1,1,1,1,1
1,0,,,,,,,,0,103-Home-0,1
1,0,,,,,,,,0,,1
1,0,301-Company-0,,,,,,,0,104-Extra-1,1
1,0,,,,10-Case-0,,200-Home-1,,0,10-Case-2,1
1,0,0,0,0,0,0,0,0,0,,1
1,,0,,,,,0,100-Company-3,,,1
1,,0,,,,,0,,,,1
1,,0,10-Case-1,,201-Company-2,201-Company-1,0,,,,1
1,,0,,,0,0,0,0,0,,1
1,,0,201,201,0,104-Company-4,,104-Company-2,0,,1
1,,0,0,0,0,,,,0,,1
1,,201-Home-3,,,0,,,,0,,1
1,,,,102,0,300-Home-2,,,0,301-Extra-0,1
1,1,1,1,1,1,1,1,1,1,1,1
